....;......;;
.!.!;!;!;!.!;
.;...;.;.;.;.
;!.!;!.!;!.!.
.....;;;...;.
.!.!;!.!;!.!;
.;...;;;.....
.!.!;!.!;!.!;
.;...;.....;.
;!;!.!;!;!.!.
;;......;....
