.....;;;...;;
.!;!.!;!;!;!;
;....;.;.....
.!;!.!.!.!;!;
.;..;...;..;.
.!;!.!;!.!;!.
;...;...;...;
.!;!.!.!.!;!.
.....;.;....;
;!;!;!;!.!;!.
;;...;;;.....
