...;......;;;
.!;!;!.!;!;!;
;......;....;
.!;!;!;!;!;!.
;.;......;..;
.!;!;!.!.!;!.
;........;.;.
.!;!;!.!;!;!.
.;.;........;
;!;!;!;!.!;!.
;;;..;.......
