.....;.....;;
.!;!.!;!;!;!;
.;.........;.
.!;!;!;!.!;!;
.;...........
;!;!.!;!;!;!;
.;.........;.
.!;!;!;!.!;!.
...........;.
;!;!;!.!;!.!.
;;...;.......
