.......;...;;
.!;!;!.!;!;!;
;....;;....;.
.!;!.!.!;!;!.
.;....;....;.
.!;!;!.!.!;!.
.;....;.....;
.!;!.!.!;!;!.
.;....;....;.
;!;!;!.!;!;!.
;;...;.......
