..........;;;
.!;!.!;!.!;!.
;;.;.;.....;.
;!;!.!;!;!;!.
.;....;.;....
.!.!.!.!.!.!;
;...;.;....;.
.!;!;!;!;!;!;
.;.......;.;;
;!;!;!.!;!;!.
;;...........
