...........;;
.!;!;!;!.!;!;
.;.;..;....;.
.!;!.!.!.!.!.
...;.;;;.;.;.
;!;!.!;!.!;!;
...;.....;.;.
.!;!.!;!.!;!.
..;..;;;.....
;!;!;!;!.!;!.
;;...........
