13 11
.....;;...;..
.!;!.!.!.!;!.
;.....;.....;
;!;!;!.!.!;!;
;........m..;
.!;!.!.!;!.!.
...m..;.....;
.!;!.!.!.!;!.
;.....;..m..;
;!;!.!.!;!.!.
;..;..;......
