............;
;!;!.!;!;!;!;
...;..;..;...
.!;!.!.!.!;!.
...;..;....;.
;!;!.!;!.!;!;
.;....;..;...
.!;!.!.!.!;!.
...;..;..;...
;!;!;!;!.!;!;
;............
