......;..;..;
.!;!;!.!.!;!.
;.;;..;..;;.;
.!;!.!;!;!;!.
.;.....;...;.
.!;!;!;!.!;!.
;;........;.;
.!;!.!;!.!;!.
;;...;.....;;
.!;!.!;!.!;!.
;..;..;......
