.....;....;;;
.!;!.!;!.!;!.
;......;;;.;.
;!;!.!;!.!.!.
.;..........;
.!;!.!;!.!;!;
;....;.......
.!.!.!.!.!;!;
.;.;.;.;...;.
;!;!;!.!.!;!.
;;...;.......
